{
	{
		{0,_,0,0,2,0},
		{1,_,_,_,_,2},
		{0,1,0,1,_,0},
		{_,_,_,0,_,0},
		{1,0,_,_,_,0},
		{_,1,0,1,0,1},
	},
	{
		{2,_,1,_,_,_},
		{_,1,0,1,0,_},
		{0,0,1,0,0,0},
		{_,2,0,1,0,_},
		{0,0,0,0,0,_},
		{_,_,_,_,_,_},
	},
	{
		{0,_,0,_,0,1},
		{_,_,1,_,4,_},
		{1,0,0,_,0,_},
		{_,_,1,_,0,_},
		{0,_,_,_,0,1},
		{1,0,1,0,1,0},
	},
}